16,12
1,1,1,1,1,1,1,1,1,1,1,1,3,1,1,1
1,1,1,1,1,1,1,3,1,2,1,1,3,1,1,1
1,1,1,1,1,1,1,1,1,1,1,1,3,1,1,1
1,1,1,1,1,1,3,1,1,1,2,1,3,1,1,1
1,1,1,1,1,1,8,4,4,4,9,1,3,1,1,1
1,1,1,1,1,1,1,1,1,1,1,1,3,1,1,1
1,1,1,1,1,1,1,1,1,1,1,1,3,1,1,1
1,1,1,1,1,1,1,1,1,1,1,1,3,1,1,1
1,1,1,1,1,1,1,1,1,1,1,1,3,1,1,1
1,1,1,1,1,1,1,1,1,1,1,1,3,1,1,1
1,1,1,1,1,1,1,1,1,1,1,1,3,1,1,1
1,1,1,1,1,1,1,1,1,1,1,1,3,1,1,1